F                    255 ,       128 ,  0
C 1, 1, 1

NO            ./resource/no_tmp_path
SO    ./resource/so_tmp_path
EA ./resource/ea_tmp_path
WE ./resource/we_tmp_path

111111111111111111111
100000000000000000001
100000000000000000001
100000000000000000001
111111111111111100001
               100001
               111111
