F 0, 255, 255
C 0, 255, 0

NO           ./resource/no_tmp_path
SO    ./resource/so_tmp_path
EA ./resource/ea_tmp_path
WE ./resource/we_tmp_path

11111111111
100000000001111111111
100000000000000000001
1000000000000000W0001
111111111111111100111
               10001
               111111
