F 0, 255, 255
C 0, 255, 0

NO           ./resource/no_tmp_path
SO    ./resource/so_tmp_path
EA ./resource/ea_tmp_path
WE ./resource/we_tmp_path

111111111111111111111
100000000000000000001
100000000000000000001
10000000000000000S001
111111111111111100111
               100001
               111111
