F 64, 64, 64
C 96, 96, 96

NO           ./resource/north_test.xpm
SO    ./resource/south_test.xpm
EA ./resource/dongkim.xpm
WE ./resource/west.xpm

11111111111
100000000001111111111
1000000000000000S0001
111111111111111100111
               10001
               111111
