F 0, 255, 255
C 0, 255, 0

NO           ./resource/north_test.xpm
SO    ./resource/south_test.xpm
EA ./resource/dongkim.xpm
WE ./resource/west.xpm

111111111111
100000000001111111111
1000000000000000S0001
111111111111111100111
               100001
               111111
